Adobe: 
Flash: [Boston, Charleston, Washington] 
Illustrator: [Miami, New_Orleans, Sacramento] 
Photoshop: [Houston, San_Antonio, Seattle] 
Apple: 
IOS: [Dallas, Los_Angeles, Miami, New_York, Washington] 
Xcode: [Atlanta, Berkeley, Detroit, Houston, Miami, Stanford, Washington] 
iWork: [Atlanta, Chicago, Los_Angeles, Miami, New_Orleans, New_York, Stanford] 
Borland: 
C++Builder: [Berkeley, Ohio, Portland, Washington, Wisconsin] 
Delphi: [Chicago, Detroit, Jackson, Miami, Milwaukee] 
JBuilder: [Denver, Miami, Santa_Fe, Tucson] 
Google: 
Chrome: [Berkeley, Denver, Houston, New_Jersey, New_York, Orlando] 
Earth: [Atlanta, Boston, Los_Angeles, Miami, New_Jersey, Ohio, Philadelphia, Washington] 
Gmail: [Miami, New_York, Phoenix, Portland, Wisconsin] 
Maps: [Detroit, Miami, New_York, Stanford, Washington] 
Talk: [Detroit, Los_Angeles, Miami, Washington] 
Translate: [Dallas, Miami, New_York, Sacramento] 
Microsoft: 
Excel: [Las_Vegas, Los_Angeles, Phoenix, Sacramento, San_Francisco] 
OutLook: [Atlanta, Miami, New_Jersey, New_York, Washington] 
PowerPoint: [Augusta, Dallas, Helena, Miami, Seattle, Washington] 
VisualC++: [Miami, New_York, Philadelphia, Stanford, Washington] 
Word: [Maryland, Memphis, Miami, New_York, Orlando, Washington] 
Oracle: 
Database_11g: [Augusta, Denver, Los_Angeles, Miami, Redwood_City] 
Java: [Dallas, Miami, New_York, Sacramento, Washington] 
Solaris: [Atlanta, Berkeley, New_York, Washington] 
Ramsoft: 
EZJava: [New_York, Stanford, Washington] 
